{
	"tileSize": 16,
	"nrRows": 27,
	"nrCols": 29,
	"levelLayout": [
		1,1,1,1,1,1,1,1,1,1,1,1,1,1,1,1,1,1,1,1,1,1,1,1,1,1,1,1,1,
		1,0,0,0,0,0,0,0,0,0,0,0,0,0,0,0,0,0,0,0,0,0,0,0,0,0,0,0,1,
		1,0,0,0,0,0,0,0,0,0,0,0,0,0,0,0,0,0,0,0,0,0,0,0,0,0,0,0,1,
		1,0,1,1,1,1,0,1,1,1,1,1,0,1,1,1,0,1,1,1,1,1,0,1,1,1,1,0,1,
		1,2,1,1,1,1,2,1,1,1,1,1,2,1,1,1,2,1,1,1,1,1,2,1,1,1,1,2,1,
		1,2,2,2,2,2,2,2,2,2,2,2,2,1,1,1,2,2,2,2,2,2,2,2,2,2,2,2,1,
		1,2,1,1,1,1,2,1,1,2,1,1,1,1,1,1,1,1,1,2,1,1,2,1,1,1,1,2,1,
		1,2,1,1,1,1,2,1,1,2,1,1,1,1,1,1,1,1,1,2,1,1,2,1,1,1,1,2,1,
		1,2,2,2,2,2,2,1,1,2,2,2,2,1,1,1,2,2,2,2,1,1,2,2,2,2,2,2,1,
		1,1,1,1,1,1,2,1,1,1,1,1,4,1,1,1,4,1,1,1,1,1,2,1,1,1,1,1,1,
		1,1,1,1,1,1,2,1,1,1,1,1,4,1,1,1,4,1,1,1,1,1,2,1,1,1,1,1,1,
		1,1,1,1,1,1,2,1,1,4,4,4,4,4,4,4,4,4,4,4,1,1,2,1,1,1,1,1,1,
		1,1,1,1,1,1,2,1,1,4,1,1,1,5,5,5,1,1,1,4,1,1,2,1,1,1,1,1,1,
		1,1,1,1,1,1,2,1,1,4,1,4,4,4,4,4,4,4,1,4,1,1,2,1,1,1,1,1,1,
		1,4,4,4,4,4,2,1,1,4,1,4,6,4,6,4,6,4,1,4,1,1,2,4,4,4,4,4,1,
		1,1,1,1,1,1,2,1,1,4,1,4,4,4,4,4,4,4,1,4,1,1,2,1,1,1,1,1,1,
		1,1,1,1,1,1,2,1,1,4,1,1,1,1,1,1,1,1,1,4,1,1,2,1,1,1,1,1,1,
		1,1,1,1,1,1,2,1,1,4,4,4,4,4,4,4,4,4,4,4,1,1,2,1,1,1,1,1,1,
		1,1,1,1,1,1,2,1,1,4,1,1,1,1,1,1,1,1,1,4,1,1,2,1,1,1,1,1,1,
		1,1,1,1,1,1,2,1,1,4,1,1,1,1,1,1,1,1,1,4,1,1,2,1,1,1,1,1,1,
		1,2,2,2,2,2,2,2,2,2,2,2,2,1,1,1,2,2,2,2,2,2,2,2,2,2,2,2,1,
		1,2,1,1,1,1,2,1,1,1,1,1,2,1,1,1,2,1,1,1,1,1,2,1,1,1,1,2,1,
		1,2,1,1,1,1,2,1,1,1,1,1,2,1,1,1,2,1,1,1,1,1,2,1,1,1,1,2,1,
		1,3,2,2,1,1,2,2,2,2,2,2,2,4,7,4,2,2,2,2,2,2,2,1,1,2,2,3,1,
		1,1,1,2,1,1,2,1,1,2,1,1,1,1,1,1,1,1,1,2,1,1,2,1,1,2,1,1,1,
		1,0,0,0,0,0,0,0,0,0,0,0,0,0,0,0,0,0,0,0,0,0,0,0,0,0,0,0,1,
		1,1,1,1,1,1,1,1,1,1,1,1,1,1,1,1,1,1,1,1,1,1,1,1,1,1,1,1,1
	]
}


